NO textures/simonkraft/wet_sponge.xpm
SO textures/simonkraft/wet_sponge.xpm
WE textures/simonkraft/wet_sponge.xpm
EA textures/simonkraft/test.xpm

F 164,169,20
C 153,204,2


              11111111111111111111
              101000001000000000001
              101010101011111110001
              100010100010000010001
              11111010111110101110111111
11111111111111111111100000101000101000001
10111110101110111111111111111111111111111
10100000101010000010             1
1010111110101111101011111111111111111
101010001010100010101
101110101010101010101
100000101010001010001
111111101011111011101
100000101000100010001
101110101110101110111
101000100000100010101
101011111111111010101
100010000000000010001
101010111011111111101
1N10000010000000001111
111111111111111111111111
111111111111111111111111












